#       #    ###
##     ###    ##
#      ###    ##
#       #     ##
#   ##         #
#########      #
#   ##  #     ##
        # ##   #
     #   ####  #
     # ## ##   #
     # ## #    #
     # ##      #
     # ##      #
     # ##      #
     # ##      #
     # ##      #
     # ##      #
     # ##      #
     #         #