#            ###
##            ##
#             ##
#             ##
#   ##         #
#########      #
#   ##  #     ##
        # ##   #
     #   ####  #
     #  # ##   #
     #  # #    #
     #  #      #
     #  #      #
     #  #      #
     #  #      #
     #  #      #
     #  #      #
     #  #      #
     #         #